8
01000000
00100000
00010000
00001000
00000100
00000010
00000001
00000000
8
1 2 3 4 5 6 7 8
