20
01001100001100011011
00111101001100001101
01010010000010000110
10101001000000000110
00110110111101100000
00111010110011100011
01101000111001110100
11111100011110000100
11111010011110011000
10001100000101100101
11001111010010100011
00001111001001111111
10011110000101001110
10001101010000111010
11010010001101010100
10101110000001001000
11110011110101100000
10110100101110010011
11101010110011110101
10010100000101110010
20
19 10 18 9 2 12 16 17 9 2 5 3 19 18 12 17 7 2 6 5
