9
010000000
001000000
000100000
000010000
000001000
000000100
000000010
000000001
000000000
9
1 2 3 4 5 6 7 8 9
