16
0100001011000101
0001010100010111
1100010111110111
0000010011111101
1001010110011110
0011001110110110
0011110011111010
0010100011100101
1001010101100100
1001110110111111
1000010011001010
1010001011000001
1100011010000111
1111110110110001
0101111100000000
0001100100110100
20
3 16 8 9 11 13 7 3 2 8 3 11 6 7 10 15 5 14 8 3
