16
0011101010011011
1001011001110111
1101110110011000
0010010011001011
1011010000010010
0110001000001011
1001110000010011
0111110001001101
0101000100110010
0010000110101011
0111110011010101
1100000101100101
0110101000000101
1111100010000001
1101001010000100
0111111101100010
20
4 16 4 16 11 3 1 5 6 2 7 12 14 16 6 2 7 15 2 7
