10
0100000000
0010000000
0001000000
0000100000
0000010000
0000001000
0000000100
0000000010
0000000001
0000000000
10
1 2 3 4 5 6 7 8 9 10
