11
01000000000
00100000000
00010000000
00001000000
00000100000
00000010000
00000001000
00000000100
00000000010
00000000001
00000000000
11
1 2 3 4 5 6 7 8 9 10 11
